{
    "A1" : {
        "A1": 0,
        "A2": 1,
        "A3": 1,
        "A4": 2,
        "A5": 3,
        "A6": 2
    },
    "A2" : {
        "A1": 1,
        "A2": 0,
        "A3": 2,
        "A4": 1,
        "A5": 2,
        "A6": 2
    },
    "A3" : {
        "A1": 1,
        "A2": 2,
        "A3": 0,
        "A4": 2,
        "A5": 3,
        "A6": 1
    },
    "A4" : {
        "A1": 2,
        "A2": 1,
        "A3": 2,
        "A4": 0,
        "A5": 1,
        "A6": 1
    },
    "A5" : {
        "A1": 3,
        "A2": 2,
        "A3": 3,
        "A4": 1,
        "A5": 0,
        "A6": 2
    },
    "A6" : {
        "A1": 2,
        "A2": 2,
        "A3": 1,
        "A4": 1,
        "A5": 2,
        "A6": 0
    }
    }